####################
#    #G         #S #
###  #####   #  #  #
##    ##    ##  #  #
#     ##    #      #
#I   ###   ##  #####
##    ##   #    #  #
#         ##  T #T +
##  MT  ###     #  #
#         ###   #  #
###########     #  #
#             ###  #
#H  ###########   ##
##        C        #
####################
