####################
B  ############    +
#  #######         #
#  ####        T   #
#  ###             #
#  ###    T        #
#  ##          C   #
#  ##              #
#   # T            #
#  T#        T   H #
#  ##    G         #
#   #              #
#  T          M    #
#       T        T #
####################
