####################
B  #G   H#     # H +
#  #  #  #  #  #   #
#  #  #  #  #  #   #
#  #  #  #  #T #   #
# T#  #  #  #  #   #
#  #  #  #  #  #   #
#  #  #  #  #  #   #
#  #  #T #  #  #   #
#C #  #  #  # T#   #
#  #  # T#  #  #   #
# T#  #  # T#  #   #
#  #  #  #  #  #   #
#    M#     #      #
####################
