####################
B  L H     T  M    #
##                ##
###           L  ###
####   Q        ####
#####      T   #####
####            ####
###              ###
##   L T          ##
#                  #
##        ##     ###
####   ####      ###
##   C ##  I      ##
#C     #           -
####################
