####################
B    H     T  M    #
##                ##
###              ###
####            ####
#####      T   #####
####            ####
###              ###
##     T          ##
#                  #
##        ##     ###
####   ####      ###
##   C ##  I      ##
#C     #           -
####################
