####################
#    #          #  #
###  #####   #  #  #
##    ##    ##  #  #
#     ##    #      #
#    ###   ##  #####
##    ##   #    #  #
#         ##    #   
##      ###     #  #
#         ###   #  #
###########     #  #
#             ###  #
#   ###########   ##
##                 #
####################

####################
+       #          #
#       #          #
#       #          #
#       #          #
#       #          #
#       #          #
#       #          #
#       #          #
#       #          #
#       #          #
#       #          #
#       #          #
#                  +
####################


####################
+                  +
#                  #
#                  #
#                  #
#                  #
#                  #
#                  #
#                  #
#                  #
#                  #
#                  #
#                  #
#                  #
####################