####################
#    # T           #
#   #####  ######  #
##    ##    T   #  #
#     ##    #   #  #
#    ###   ##  ##  #
##    ##   #T   #  #
#    ##   ##   #T  #
##    #        #   +
#    #######  ######
#    ######       S#
#   #         ######
#         ##########
#G      ############
####################
