####################
-                  -
#                  #
#                  #
#                  #
#                  #
#                  #
#     T            #
#        TT        #
#                  #
#                  #
#                  #
#                  #
#                  #
####################