####################
B          T       #
##                ##
###              ###
####            ####
#####      T   #####
####            ####
###              ###
##     T          ##
#                  #
##        ##     ###
####   ####      ###
##     ##  I      ##
#      #           -
####################
