####################
B       #          #
#       #          #
#       #     I    #
#       #          #
#       #          #
#   G   #          #
#       #          #
#       #          #
#       #          #
#       #          #
#      T#T         #
#       #          #
#     T   T        +
####################
