####################
#         C        #
################# T#
#                  #
#T #################
#          M      ##
###############  ###
###   T           ##
####     ###     ###
##    ########    ##
#               T ##
#  Q   S#####   T ##
#    ##########    #
#   T           H  +
####################