####################
#       #          #
#       #          #
#       #          #
#       #          #
#       #          #
#       #     F    #
#       #          #
#       #          #
#       #          #
#       #          #
#      T#T         #
#       #          #
#     T   T        +
####################