####################
B  ############    +
#  #######         #
#  ####        T   #
#  ###             #
#  ###    T        #
#  ##              #
#  ##              #
#   # T            #
#  T#        T     #
#  ##    G         #
#   #              #
#  T               #
#       T        T #
####################
