####################
B                CM#
#  ######## ########
#   H###T   ####   +
#  ####       ##  ##
#          ## #   ##
#######  #### #   ##
## T       ## #  ###
#     ###   # #    #
#  Q ####     #T   #
#     T## #####   T#
# T     #  ## # T  #
#         ##       #
##T#  #      # T#  #
####################
