####################
#    # T           #
#   #####  ######  #
## L  ##    T   #  #
#     ##    #   #  #
#    ###   ##  ##  #
##    ##   #T   #  #
#  Q ##   ##   #T  #
##    #        #   +
#    #######  ######
#    ######       S#
#   #H      M ######
#C        ##########
#G      ############
####################