#####################
#P                 #
###                #
##                 #
#                  #
#                 ###
##                 #
#                  #
##                 #
#                  #
##                 #
#                  #
#                 ##
##                W#
####################
