####################
B  ############    +
#  #######         #
#  ####        T   #
#  ###             #
#  ###    T        #
#  ##  Q       C   #
#  ##              #
#   # T   L        #
#  T#        T   H #
#  ##    G         #
#   #              #
#  T          M    #
#       T        T #
####################
