####################
                   +
#                  #
#                  #
#                  #
#                  #
#                  #
#     T            #
#        TT        #
#                  #
#                  #
#                  #
#                  #
#                  #
####################