####################
B                  +
#                  #
#    M             #
#            G     #
#                  #
#                  #
#     T            #
#            H  C  #
#                  #
#                  #
#   I              #
#                  #
#                  #
####################