####################
+       #          #
#       #          #
#       #          #
#       #          #
#       #          #
#       #          #
#       #          #
#       #          #
#       #          #
#       #          #
#       #          #
#       #          #
#                  +
####################