####################
B                  +
#                  #
# L  M             #
#            G     #
#                  #
#         Q        #
#     T            #
#            H  C  #
#          L       #
#                  #
#   I              #
#                  #
#                  #
####################