####################
#    #G         #S #
###  #####   #  #  #
## I  ##    ##  #  #
#     ##    #      #
#    ###   ##  #####
##  Q ##   #    #  #
#         ##  T #T +
##  MT  ###     #  #
#         ###   #  #
###########     #  #
#             ###  #
#H  ###########   ##
##        C        #
####################
