#####################
#                  #
###                #
##                 #
#                  #
#                 ###
##                 #
#                  #
##                 #
#                  #
##                 #
#                  #
#                 ##
##                 #
####################