####################
B       #          #
#       #          #
#       #     I    #
#   G   #          #
#       #          #
#   H   #       C  #
#       #  H       #
#       #          #
#       #          #
# M     #          #
#      T#T         #
#   C   #          #
#     T   T        +
####################
