####################
#    #G         #S #
###  #####   #  #  #
##    ##    ##  #  #
#     ##    #      #
#I   ###   ##  #####
##    ##   #    #  #
#         ##  T #T +
##  T   ###     #  #
#         ###   #  #
###########     #  #
#             ###  #
#   ###########   ##
##                 #
####################
