####################
#    # T           #
#   #####  ######  #
##    ##    T   #  #
#     ##    #   #  #
#    ###   ##  ##  #
##    ##   #T   #  #
#    ##   ##   #T  #
##    #        #   +
#    #######  ######
#    ######        #
#   #         ######
#         ##########
#       ############
####################